111111111111111111111111111
1C000000E0000000000C00000C1
1000001000C00000000G0000001
10000000010000E00000G000001
1C0000G000000000000C000P0C1
111111111111111111111111111