111111111111111111111111111
1C000000E0000000000C00000C1
1000001000C00000C0000000001
10000000010000E000000000001
1C0000000C000000000C000P0C1
111111111111111111111111111